=============================
=                           =
=                           =
=                           =
=                        !  =
=======================     =
=                           =
=                           =
=                           =
=                           =
=     =======================
=                           =
=                           =
=                           =
=                           =
=======================     =
=                           =
=                           =
=  !                        =
=                           =
=     =======================
=                           =
=                           =
=                           =
=                           =
=======================     =
=                           =
=             !             =
=                           =
=                          ==
=           =====           =
=                           =
=                           =
=                           =
=  $                        =
=============================