=============================
=                           =
=                           =
=                           =
=                         ! =
=========================   =
=                           =
=                           =
=                           =
=                           =
=   =========================
=                           =
=                           =
=                           =
=                           =
=========================   =
=                           =
=                           =
= !                         =
=                           =
=   =========================
=                           =
=                           =
=                           =
=                           =
=========================   =
=                           =
=             !             =
=                           =
=                          ==
=           =====           =
=                           =
=                           =
=                           =
=  $                        =
=============================