============================
=                          =
=                          =
=                          =
========                   =
=                          =
=                          =
=                          =
=                          =
=                          =
=                          =
=                          =
=                          =
=                          =
=                          =
=                          =
=                          =
=                          =
=                          =
=                          =
=                          =
=                          =
=                          =
=                          =
=                          =
=                          =
=                          =
=                          =
=                          =
=                          =
=                          =
=                          =
=                          =
=                          =
=                          =
============================