============================
=                          =
=                          =
=                          =
=                          =
=                          =
==============             =
=                          =
=                          =
=                          =
=                          =
=                          =
=                          =
=                          =
=                          =
=                          =
=                          =
=                          =
=                          =
=                          =
=                          =
=                          =
=                          =
=                          =
=                          =
=                          =
=                          =
=                          =
=                          =
=                          =
=                          =
=                          =
=                          =
=                          =
=                          =
============================