============================
=                          =
=                          =
=                          =
=                          =
=                          =
==============             =
=                          =
=                          =
=                          =
=                        ! =
=                          =
=             ==============
=                          =
=                          =
=                          =
=                          =
=                 !        =
==============             =
=                          =
=                          =
=                          =
=                          =
=                          =
=             ==============
=                          =
=                          =
=                          =
=                          =
=                          =
==============             =
=                        ! =
=                          =
=                          =
=                          =
============================