=============================
=                           =
=                          !=
=                           =
=                           =
=============              ==
=                           =
=                           =
=                           =
=                           =
=                ============
=                           =
=                           =
=                           =
=                           =
=============               =
=                           =
=                ==         =
= !                         =
=                           =
==============         ======
=                           =
=                           =
=                           =
=                           =
=         =========         =
=             !             =
=                           =
=                           =
=     =               =     =
=             =             =
=                           =
=                           =
=                           =
=                           =
=============================