=============================
=                           =
=                           =
=                           =
=                           =
====             !          =
=  ===                      =
=    ===                    =
= !    ===                  =
=        ===             ====
=                      ===  =
=                    ===    =
=                  ===      =
=                ===        =
=                           =
=                           =
=============               =
=                           =
=                           =
=                           =
=                ===        =
=                           =
=                           =
=         ===               =
=                        ====
= !                         =
=                           =
=                           =
======                      =
=                   ===     =
=                           =
=                           =
=                           =
=                           =
=                        $  =
=============================