=============================
=             !             =
=                           =
=                           =
=                           =
====                        =
=                           =
=                           =
=      ===    =    ===      =
=                           =
=                        ====
= !                         =
=                           =
=                           =
=                           =
====               ===      =
=                           =
=                           =
=        ====               =
=                           =
=                        ====
=                           =
=                           =
=                  =        =
=                           =
====                        =
=            !              =
=                           =
=         ======            =
=                           =
=                   =====   =
=                           =
=                           =
=                           =
=                           =
=============================