=============================
=                           =
=                           =
=                           =
=                           =
======         =====        =
=    ===     ===            =
= !    =======              =
=                           =
=                     ==    =
=                           =
=                           =
===                         =
=                           =
=                 ===========
=            ======         =
=        =====              =
=     ====                  =
=   ===                     =
=                           =
=                           =
=               ====    =====
=          ======           =
============                =
=                           =
=                           =
=              !    ====    =
=                     !     =
=             ===           =
======                      =
= $                         =
=                           =
=                           =
=                           =
=                           =
=============================