=============================
=                           =
=                         ! =
=                           =
=                           =
===           ===      ======
=  ==            ===        =
= !  ==                     =
=      ==                   =
=        ==                 =
=          ==               =
=            ==         =====
=====                 ==    =
=                   ==   $  =
= !  ==                     =
=      ==                   =
=                           =
=          ====             =
=                   ====    =
=                           =
=                           =
=====                       =
=                =          =
=                           =
=                           =
=                           =
=     ====                  =
=         ====      ======  =
=                           =
=                           =
=                           =
=                           =
=                           =
=                           =
=                           =
=============================